A	AH
A(2)	EY
ABOUT	AH B AW T
DOWN	D AW N
FIVE	F AY V
HELM	HH EH L M
HO	HH OW
JIBE	JH AY B
LEE	L IY
LEFT	L EH F T
MY	M AY
ONE	W AH N
ONE(2)	HH W AH N
READY	R EH D IY
RIGHT	R AY T
STANDBY	S T AE N D B AY
TEN	T EH N
TO	T UW
TO(2)	T IH
TO(3)	T AH
UP	AH P
